                                            
 ####################  #####################
 #                                   *     #
 #      *     *                            #
 #################################  ########
 #                                      *  #
 #                                         #
 #   ###############  ###############      #
 #       # *                #  *           #
 #       ####################              #
 #             *  #                        #
 #       ####################              #
 # *              #  *                     #
 ###########################################